name Small Labyrinth of Dooom
win 6
E.###############.#
..G...G...GA..G..L.
#.#.#.##.########G#
#.#.#S#..G..L.G...#
#.#.#.##H##.##.##.#
#G#.#.##.##A##.##.#
#.#.#GG..S.L..GG..#
#H#.####H########.#
#.#.GG...A.S..L...#
#S#.####.########.#
..G....G...L..GG.H.
#.###############.E
